1111111111111111111
1111110011111111111
1111110P00011111111
1000C00000C0000C001
10C0000C00000C00001
10000C000000C000001
100C01111111100E011
1111111111111001111
1111111111111111111
1111111111111111111
